XXXXXXXXXXX
P     X   X
X XXXXXXX X
X X       X
X X XXX XXX
X X   X   X
X XXXXXXX X
X         X
XXXXXXXXX X
X         K
XXXXXXXXXXX

